P,P,P,P,P,P,P,P
P,P,P,P,P,P,P,P
P,P,P,P,P,P,P,P
P,P,P,P,P,P,P,P
P,P,P,P,P,P,P,P
P,P,C,C,C,C,C,P
P,P,C,P,P,P,C,P
P,C,C,C,C,P,C,P
P,P,P,P,C,P,C,S
P,P,C,P,C,P,P,P
P,C,C,C,C,C,P,P
P,P,C,P,P,C,P,P
P,P,C,P,P,P,P,P
A,A,E,A,A,A,A,A